dogs	Собаки
pigs	Свиньи
slaves	Рабы
elephants	Слоны
camels	Верблюды
gold	Золото
silver	Серебро
iron	Железо
pottery	Гончарные изделия
furs	Меха
grain	Зерно
timber	Лес
olive_oil	Оливковое масло
wine	Вино
glass	Стекло
marble	Мрамор
textiles	Ткани
purple_dye	Пурпурная краска
incense	Фимиам
silk	Шелк
wild_animals	Дикие животные
hides	Шкуры
tin	Олово
copper	Медь
lead	Свинец
amber	Янтарь
